58
0-0	0	0
	0
0-1	128	0
	1	348
0-2	256	0
	3	144	151	183
0-3	384	0
	9	26	27	28	29	30	145	152	184	203
0-4	512	0
	10	0	1	2	31	32	33	34	166	200	250
0-5	640	0
	10	3	4	5	6	7	153	167	185	217	289
0-6	768	0
	3	146	343	344
0-7	896	0
	6	154	173	186	204	222	344
0-8	1024	0
	9	8	9	10	175	330	332	334	342	351
0-9	1152	0
	10	11	12	13	14	175	201	218	334	341	352
0-10	1280	0
	10	15	35	36	37	38	39	156	188	219	231
0-11	1408	0
	14	40	41	42	43	44	45	46	47	156	157	168	188	189	347
0-12	1536	0
	13	16	17	18	48	49	50	51	176	177	178	202	251	346
0-13	1664	0
	8	19	20	21	22	23	178	220	290
0-14	1792	0
	7	24	149	331	333	335	340	349
0-15	1920	0
	7	25	149	221	291	335	339	350
0-16	2048	0
	7	52	160	161	169	192	193	205
0-17	2176	0
	4	53	54	55	223
0-18	2304	0
	3	162	179	194
0-19	2432	0
	2	163	195
0-20	2560	0
	4	164	172	180	196
0-21	2688	0
	9	56	57	58	59	60	172	180	181	206
0-22	2816	0
	6	61	62	63	165	197	224
0-23	2944	0
	6	182	247	248	249	252	253
0-24	3072	0
	0
0-25	3200	0
	0
0-26	3328	0
	0
0-27	3456	0
	0
0-28	3584	0
	0
1-0	0	110
	8	91	92	93	94	95	96	97	98
1-1	128	110
	8	99	100	101	102	103	104	105	106
1-2	256	110
	10	64	65	66	67	68	69	70	144	207	260
1-3	384	110
	10	26	27	28	29	30	71	72	145	203	254
1-4	512	110
	4	31	32	33	34
1-5	640	110
	7	289	292	295	300	307	316	322
1-6	768	110
	17	146	208	214	225	229	261	269	274	275	281	282	308	317	323	324	343	344
1-7	896	110
	15	107	108	109	204	222	232	255	258	262	270	276	283	296	301	344
1-8	1024	110
	11	110	111	112	113	155	174	187	330	332	336	342
1-9	1152	110
	11	114	115	116	117	147	148	155	187	236	237	341
1-10	1280	110
	12	35	36	37	38	39	73	74	118	231	238	239	240
1-11	1408	110
	15	40	41	42	43	44	45	46	47	75	76	119	168	241	242	243
1-12	1536	110
	10	48	49	50	51	120	121	122	123	124	244
1-13	1664	110
	9	125	158	190	245	290	293	309	318	325
1-14	1792	110
	11	159	191	215	230	277	284	285	326	331	333	337
1-15	1920	110
	16	209	226	263	271	278	286	291	294	297	302	310	311	319	320	327	328
1-16	2048	110
	14	52	77	78	79	80	81	169	205	210	256	264	272	279	287
1-17	2176	110
	12	53	54	55	126	127	128	170	223	233	298	303	312
1-18	2304	110
	11	82	83	129	130	131	211	227	234	265	304	313
1-19	2432	110
	11	84	85	86	132	133	134	135	163	171	212	266
1-20	2560	110
	12	87	88	136	137	138	172	213	228	235	267	305	314
1-21	2688	110
	10	56	57	58	59	60	89	90	172	206	257
1-22	2816	110
	10	61	62	63	224	299	306	315	321	329	338
1-23	2944	110
	15	139	140	141	142	143	150	199	216	253	259	268	273	280	288	338
1-24	3072	110
	0
1-25	3200	110
	0
1-26	3328	110
	0
1-27	3456	110
	0
1-28	3584	110
	0
