0	0	0	768	176	4	0
01	0	0	384	88	4	0
011	0	0	192	44	0	1	1
012	192	0	192	44	0	1	2
013	0	44	192	44	0	2	0	1
014	192	44	192	44	0	2	0	2
02	384	0	384	88	0	0
03	0	88	384	88	4	0
031	0	88	192	44	0	2	0	1
032	192	88	192	44	0	2	0	2
033	0	132	192	44	0	3	0	1	3
034	192	132	192	44	0	3	0	2	3
04	384	88	384	88	0	0
