58
0-0	0	0
	0
0-1	128	0
	0
0-2	256	0
	3	144	151	185
0-3	384	0
	9	26	27	28	29	30	145	152	186	205
0-4	512	0
	10	0	1	2	31	32	33	34	166	202	261
0-5	640	0
	10	3	4	5	6	7	153	167	187	219	304
0-6	768	0
	3	146	249	250
0-7	896	0
	6	154	173	188	206	224	250
0-8	1024	0
	8	8	9	10	175	252	348	350	352
0-9	1152	0
	13	11	12	13	14	175	203	220	251	254	262	265	305	352
0-10	1280	0
	12	15	35	36	37	38	39	156	190	221	233	303	306
0-11	1408	0
	15	40	41	42	43	44	45	46	47	156	157	168	176	177	190	191
0-12	1536	0
	12	16	17	18	48	49	50	51	178	179	180	204	263
0-13	1664	0
	7	19	20	21	22	23	222	307
0-14	1792	0
	6	24	149	255	349	351	353
0-15	1920	0
	6	25	149	223	256	308	353
0-16	2048	0
	7	52	160	161	169	194	195	207
0-17	2176	0
	4	53	54	55	225
0-18	2304	0
	3	162	181	196
0-19	2432	0
	2	163	197
0-20	2560	0
	4	164	172	182	198
0-21	2688	0
	9	56	57	58	59	60	172	182	183	208
0-22	2816	0
	6	61	62	63	165	199	226
0-23	2944	0
	6	184	258	259	260	264	266
0-24	3072	0
	0
0-25	3200	0
	0
0-26	3328	0
	0
0-27	3456	0
	0
0-28	3584	0
	0
1-0	0	110
	8	91	92	93	94	95	96	97	98
1-1	128	110
	8	99	100	101	102	103	104	105	106
1-2	256	110
	10	64	65	66	67	68	69	70	144	209	274
1-3	384	110
	10	26	27	28	29	30	71	72	145	205	267
1-4	512	110
	4	31	32	33	34
1-5	640	110
	7	304	309	313	318	325	334	340
1-6	768	110
	17	146	210	216	227	231	249	250	275	283	288	289	295	296	326	335	341	342
1-7	896	110
	15	107	108	109	206	224	234	250	268	272	276	284	290	297	314	319
1-8	1024	110
	10	110	111	112	113	155	174	189	253	348	350
1-9	1152	110
	16	114	115	116	117	147	148	155	189	238	239	253	254	265	269	305	310
1-10	1280	110
	13	35	36	37	38	39	73	74	118	233	240	241	242	306
1-11	1408	110
	15	40	41	42	43	44	45	46	47	75	76	119	168	243	244	245
1-12	1536	110
	10	48	49	50	51	120	121	122	123	124	246
1-13	1664	110
	9	125	158	192	247	307	311	327	336	343
1-14	1792	110
	10	159	193	217	232	291	298	299	344	349	351
1-15	1920	110
	16	211	228	277	285	292	300	308	312	315	320	328	329	337	338	345	346
1-16	2048	110
	14	52	77	78	79	80	81	169	207	212	270	278	286	293	301
1-17	2176	110
	12	53	54	55	126	127	128	170	225	235	316	321	330
1-18	2304	110
	11	82	83	129	130	131	213	229	236	279	322	331
1-19	2432	110
	11	84	85	86	132	133	134	135	163	171	214	280
1-20	2560	110
	12	87	88	136	137	138	172	215	230	237	281	323	332
1-21	2688	110
	10	56	57	58	59	60	89	90	172	208	271
1-22	2816	110
	10	61	62	63	226	257	317	324	333	339	347
1-23	2944	110
	15	139	140	141	142	143	150	201	218	257	266	273	282	287	294	302
1-24	3072	110
	0
1-25	3200	110
	0
1-26	3328	110
	0
1-27	3456	110
	0
1-28	3584	110
	0
