58
0-0	0	0
	0
0-1	128	0
	0
0-2	256	0
	3	144	151	185
0-3	384	0
	9	26	27	28	29	30	145	152	186	205
0-4	512	0
	10	0	1	2	31	32	33	34	166	202	252
0-5	640	0
	10	3	4	5	6	7	153	167	187	219	295
0-6	768	0
	2	146	345
0-7	896	0
	6	154	173	188	206	224	346
0-8	1024	0
	8	8	9	10	175	339	341	343	347
0-9	1152	0
	12	11	12	13	14	175	203	220	253	256	296	343	348
0-10	1280	0
	12	15	35	36	37	38	39	156	190	221	233	294	297
0-11	1408	0
	15	40	41	42	43	44	45	46	47	156	157	168	176	177	190	191
0-12	1536	0
	12	16	17	18	48	49	50	51	178	179	180	204	254
0-13	1664	0
	7	19	20	21	22	23	222	298
0-14	1792	0
	6	24	149	340	342	344	352
0-15	1920	0
	6	25	149	223	299	344	354
0-16	2048	0
	7	52	160	161	169	194	195	207
0-17	2176	0
	4	53	54	55	225
0-18	2304	0
	3	162	181	196
0-19	2432	0
	2	163	197
0-20	2560	0
	4	164	172	182	198
0-21	2688	0
	9	56	57	58	59	60	172	182	183	208
0-22	2816	0
	6	61	62	63	165	199	226
0-23	2944	0
	6	184	249	250	251	255	257
0-24	3072	0
	0
0-25	3200	0
	0
0-26	3328	0
	0
0-27	3456	0
	0
0-28	3584	0
	0
1-0	0	110
	8	91	92	93	94	95	96	97	98
1-1	128	110
	8	99	100	101	102	103	104	105	106
1-2	256	110
	10	64	65	66	67	68	69	70	144	209	265
1-3	384	110
	10	26	27	28	29	30	71	72	145	205	258
1-4	512	110
	4	31	32	33	34
1-5	640	110
	7	295	300	304	309	316	325	331
1-6	768	110
	16	146	210	216	227	231	266	274	279	280	286	287	317	326	332	333	345
1-7	896	110
	15	107	108	109	206	224	234	259	263	267	275	281	288	305	310	346
1-8	1024	110
	11	110	111	112	113	155	174	189	339	341	349	350
1-9	1152	110
	16	114	115	116	117	147	148	155	189	238	239	256	260	296	301	349	351
1-10	1280	110
	14	35	36	37	38	39	73	74	118	233	240	241	242	297	351
1-11	1408	110
	15	40	41	42	43	44	45	46	47	75	76	119	168	243	244	245
1-12	1536	110
	10	48	49	50	51	120	121	122	123	124	246
1-13	1664	110
	9	125	158	192	247	298	302	318	327	334
1-14	1792	110
	11	159	193	217	232	282	289	290	335	340	342	353
1-15	1920	110
	16	211	228	268	276	283	291	299	303	306	311	319	320	328	329	336	337
1-16	2048	110
	14	52	77	78	79	80	81	169	207	212	261	269	277	284	292
1-17	2176	110
	12	53	54	55	126	127	128	170	225	235	307	312	321
1-18	2304	110
	11	82	83	129	130	131	213	229	236	270	313	322
1-19	2432	110
	11	84	85	86	132	133	134	135	163	171	214	271
1-20	2560	110
	12	87	88	136	137	138	172	215	230	237	272	314	323
1-21	2688	110
	10	56	57	58	59	60	89	90	172	208	262
1-22	2816	110
	10	61	62	63	226	308	315	324	330	338	355
1-23	2944	110
	15	139	140	141	142	143	150	201	218	257	264	273	278	285	293	355
1-24	3072	110
	0
1-25	3200	110
	0
1-26	3328	110
	0
1-27	3456	110
	0
1-28	3584	110
	0
